NO ./textures/greystone.xpm
SO ./textures/bluestone.xpm
WE ./textures/redbrick.xpm
EA ./textures/eagle.xpm

F 255,255,255
C 0,0,0

        1111111111111111111111111
        1000000000000000000000001
        1000000000000000000000001
        10000000000000000W0000001
111111111011000001110000000000001
100000000011000001110111111111111
11110111111111011100000010001
11110111111111011101010010001
11000000110101011100000010001
10000000000000000000000010001
10000000000000001101010010001
1100000111010101111101111010111
11110111 1110101 101111010001
11111111 1111111 111111111111
